mapVersion=3
50
Backyard
60
YYYYYYYYYYYYYYYYYYYYYYYYYYYYYYYYYYYYYYYYYYYYYYYYYY
YXXX          RY      RRYYRR      YR          XXXY
YXX           RY XXXXXRRYYRRXXXXX YR           XXY
YX     YYYYYYYYY      RRYYRR      YYYYYYYYY     XY
Y      Y     Y    XXXXRRYYRRXXXX    Y     Y      Y
Y   X  Y     Y        RRYYRR        Y     Y  X   Y
Y   X  Y  Y  Y  Y XXXXRRYYRRXXXX Y  Y  Y  Y  X   Y
Y   X  Y  Y  Y  Y     RRYYRR     Y  Y  Y  Y  X   Y
Y   X  Y  Y  Y  Y XXXXRRYYRRXXXX Y  Y  Y  Y  X   Y
Y   X  Y  Y  Y  Y     RRYYRR     Y  Y  Y  Y  X   Y
Y   X  Y  Y  Y  Y XXXXRRYYRRXXXX Y  Y  Y  Y  X   Y
Y   X  Y  Y  Y  Y     RRYYRR     Y  Y  Y  Y  X   Y
Y   X     Y     Y XXXXRRYYRRXXXX Y     Y     X   Y
Y   X1    Y     Y     RRYYRR     Y     Y    3X   Y
Y   XXXXXXXXXXXXXXXXXXXXXXXXXXXXXXXXXXXXXXXXXX   Y
Y      YYYYYYYYYYYYYYYYYYYYYYYYYYYYYYYYYYYY      Y
Y         XXXXXXXXX            XXXXXXXXX         Y
Y          XXXXXXX    YRRRRY    XXXXXXX          Y
Y                    YRRRRRRY                    Y
Y Y                 YXXXRRXXXY                 Y Y
Y YX               YRXRRRRRRXRY               XY Y
Y YXXXXXX    Y     RRRRRRRRRRRR     Y    XXXXXXY Y
Y YXXYYYYY   Y     RRXRRRRRRXRR     Y   YYYYYXXY Y
Y YXXYRR     YX    RRXRRRRRRXRR    XY     RRYXXY Y
Y YXXYRR     YXXXX RRXRRRRRRXRR XXXXY     RRYXXY Y
Y YXXYRR     YXXXX RRXRRRRRRXRR XXXXY     RRYXXY Y
Y YXXYRR     YX    RRXRRRRRRXRR    XY     RRYXXY Y
Y YXXYYYYY   Y     RRXRRRRRRXRR     Y   YYYYYXXY Y
Y YXXXXXX    Y     RRRRRRRRRRRR     Y    XXXXXXY Y
Y YX               YRXRRRRRRXRY               XY Y
Y Y                 YXXXRRXXXY                 Y Y
Y                    YRRRRRRY                    Y
Y          XXXXXXX    YRRRRY    XXXXXXX          Y
Y         XXXXXXXXX            XXXXXXXXX         Y
Y      YYYYYYYYYYYYYYYYYYYYYYYYYYYYYYYYYYYY      Y
Y   XXXXXXXXXXXXXXXXXXXXXXXXXXXXXXXXXXXXXXXXXX   Y
Y   X2    Y     Y     RRYYRR     Y     Y    4X   Y
Y   X     Y     Y XXXXRRYYRRXXXX Y     Y     X   Y
Y   X  Y  Y  Y  Y     RRYYRR     Y  Y  Y  Y  X   Y
Y   X  Y  Y  Y  Y XXXXRRYYRRXXXX Y  Y  Y  Y  X   Y
Y   X  Y  Y  Y  Y     RRYYRR     Y  Y  Y  Y  X   Y
Y   X  Y  Y  Y  Y XXXXRRYYRRXXXX Y  Y  Y  Y  X   Y
Y   X  Y  Y  Y  Y     RRYYRR     Y  Y  Y  Y  X   Y
Y   X  Y  Y  Y  Y XXXXRRYYRRXXXX Y  Y  Y  Y  X   Y
Y   X  Y     Y        RRYYRR        Y     Y  X   Y
Y      Y     Y    XXXXRRYYRRXXXX    Y     Y      Y
YX     YYYYYYYYY      RRYYRR      YYYYYYYYY     XY
YXX           RY XXXXXRRYYRRXXXXX YR           XXY
YXXX          RY      RRYYRR      YR          XXXY
YYYYYYYYYYYYYYYYYYYYYYYYYYYYYYYYYYYYYYYYYYYYYYYYYY
