mapVersion=3
42
Central
20
YYYYYYYYYYYYYYYYYYYYYYYYYYYYYYYYYYYYYYYYYY
Y                  XXXX                  Y
Y                   XX                   Y
Y   YYYYYYYYYYYYYRRRRRRRRYYYYYYYYYYYYY   Y
Y           YRRRYRRRRRRRRYRRRY           Y
Y           YRRRYRRRRRRRRYRRRY           Y
Y           YRRRYRRRRRRRRYRRRY           Y
YXXXXXXXXX  Y   YRRRYYRRRY   Y   XXXXXXXXY
Y           Y   YYYYYYYYYY   Y           Y
Y           Y       YY       Y           Y
Y           Y       YY       Y           Y
Y   YRRRR   Y       YY       Y   RRRRY   Y
Y   YRRRRR  Y       YY       Y  RRRRRY   Y
Y   YRRRRR  Y   Y   YY   Y   Y  RRRRRY   Y
Y   YRRRRR  Y   Y   YY   Y   Y  RRRRRY   Y
Y   YYRRRR      Y   YY   Y      RRRRYY   Y
Y    YYRRR      Y 1 YY 3 Y      RRRYY    Y
YX    YYRR      Y   YY   Y      RRYY    XY
YX     YYYYYYYYYYXXXYYXXXYYYYYYYYYY     XY
YX       RRRRRRRRRRRRRRRRRRRRRRRR       XY
YXXX     RRYRRRRYRRRRRRRRYRRRRYRR     XXXY
YXXX     RRYRRRRYRRRRRRRRYRRRRYRR     XXXY
YX       RRRRRRRRRRRRRRRRRRRRRRRR       XY
YX     YYYYYYYYYYXXXYYXXXYYYYYYYYYY     XY
YX    YYRR      Y   YY   Y      RRYY    XY
Y    YYRRR      Y 2 YY 4 Y      RRRYY    Y
Y   YYRRRR      Y   YY   Y      RRRRYY   Y
Y   YRRRRR  Y   Y   YY   Y   Y  RRRRRY   Y
Y   YRRRRR  Y   Y   YY   Y   Y  RRRRRY   Y
Y   YRRRRR  Y       YY       Y  RRRRRY   Y
Y   YRRRR   Y       YY       Y   RRRRY   Y
Y           Y       YY       Y           Y
Y           Y       YY       Y           Y
Y           Y   YYYYYYYYYY   Y           Y
YXXXXXXXX   Y   YRRRYYRRRY   Y   XXXXXXXXY
Y           YRRRYRRRRRRRRYRRRY           Y
Y           YRRRYRRRRRRRRYRRRY           Y
Y           YRRRYRRRRRRRRYRRRY           Y
Y   YYYYYYYYYYYYYRRRRRRRRYYYYYYYYYYYYY   Y
Y                   XX                   Y
Y                  XXXX                  Y
YYYYYYYYYYYYYYYYYYYYYYYYYYYYYYYYYYYYYYYYYY
