mapVersion=3
20
Newbie
8
YYYYYYYYYYYYYYYYYYYY
Y                  Y
Y 1              2 Y
Y                  Y
Y   XXXXX  XXXXX   Y
Y   X          X   Y
Y   X          X   Y
Y   X          X   Y
Y   X   RRRR   X   Y
Y       RRRR       Y
Y       RRRR       Y
Y   X   RRRR   X   Y
Y   X          X   Y
Y   X          X   Y
Y   X          X   Y
Y   XXXXX  XXXXX   Y
Y                  Y
Y 3              4 Y
Y                  Y
YYYYYYYYYYYYYYYYYYYY