mapVersion=3
21
Source
8
YYYYYYYYYYYYYYYYYYYYY
YRYYYYR       RYYYYRY
Y RYYYYRR   RRYYYYR Y
Y   YYYYYY YYYYYY   Y
YX   RRRYY YYRRR   XY
Y X      R R      X Y
Y                   Y
Y                   Y
Y        X X        Y
Y 1 X    X X    X 2 Y
YYYYYRR       RRYYYYY
Y 3 X    X X    X 4 Y
Y        X X        Y
Y                   Y
Y                   Y
Y X      R R      X Y
YX   RRRYY YYRRR   XY
Y   YYYYYY YYYYYY   Y
Y RYYYYRR   RRYYYYR Y
YRYYYYR       RYYYYRY
YYYYYYYYYYYYYYYYYYYYY
